1111111111111111
1000100011000101
1101101000000001
1000E011P1000101
1000000000000101
1111111111111111
