1111111111111111
10C00001010001E1
11111010P0100001
1000001101000111
1000000010000101
1111111111111111

