1111111111
1EP00000011
10C0000001111
100000001111111
100000001
111111111