1111111111111111
10E01000110001E1
11011010P0000001
10C0001101000101
100000000E00C101
1111111111111111