1111111111111111
10001000110001E1
11011010P0000001
10C0X01101000101
100000000000C101
1111111111111111

