11111111111111111111111
100C1000000001C110C0001
111000V00100P0001010E01
10C000001001100000V0011
10000V000000000V0000001
11111111111111111111111