# **************************************************************************** #
#                                                                              #
#                                                         :::      ::::::::    #
#    valid.ber                                          :+:      :+:    :+:    #
#                                                     +:+ +:+         +:+      #
#    By: thlefebv <marvin@42.fr>                    +#+  +:+       +#+         #
#                                                 +#+#+#+#+#+   +#+            #
#    Created: 2023/11/09 16:17:58 by thlefebv          #+#    #+#              #
#    Updated: 2023/11/09 16:18:00 by thlefebv         ###   ########.fr        #
#                                                                              #
# **************************************************************************** #

1111111111111111111111111111111111111
10C01000000011C1100000000000000001C01
1000100001001101100000000000000001001
1110000001000000111000001111000000011
11110000000000001P1000001111000000001
1001000000000000000000000000000110011
1000000000000010100000000000000111C01
10C100000000001E100000011110000000001
1111111111111111111111111111111111111