1111111111111111
10001000110001E1
11011010P0000000
10C0001101000101
100000000000C101
1111111111111111
